#sort-radix_a	$MERLIN_COMPILER_HOME/regression_test/test_case/machsuite_set2/sort-radix_a
fft-transpose_a	$MERLIN_COMPILER_HOME/regression_test/test_case/machsuite_set2/fft-transpose_a
bfs-bulk_a	$MERLIN_COMPILER_HOME/regression_test/test_case/machsuite_set2/bfs-bulk_a
bfs-bulk_x	$MERLIN_COMPILER_HOME/regression_test/test_case/machsuite_set2/bfs-bulk_x
fft-transpose_x	$MERLIN_COMPILER_HOME/regression_test/test_case/machsuite_set2/fft-transpose_x
sort-radix_x	$MERLIN_COMPILER_HOME/regression_test/test_case/machsuite_set2/sort-radix_x
fft-strided_x	$MERLIN_COMPILER_HOME/regression_test/test_case/machsuite_set2/fft-strided_x
bfs-queue_a	$MERLIN_COMPILER_HOME/regression_test/test_case/machsuite_set2/bfs-queue_a
backprop_a	$MERLIN_COMPILER_HOME/regression_test/test_case/machsuite_set2/backprop_a
gemm-ncubed_x	$MERLIN_COMPILER_HOME/regression_test/test_case/machsuite_set2/gemm-ncubed_x
gemm-ncubed_a	$MERLIN_COMPILER_HOME/regression_test/test_case/machsuite_set2/gemm-ncubed_a
backprop_x	$MERLIN_COMPILER_HOME/regression_test/test_case/machsuite_set2/backprop_x
fft-strided_a	$MERLIN_COMPILER_HOME/regression_test/test_case/machsuite_set2/fft-strided_a
bfs-queue_x	$MERLIN_COMPILER_HOME/regression_test/test_case/machsuite_set2/bfs-queue_x
md-knn_a	$MERLIN_COMPILER_HOME/regression_test/test_case/machsuite_set2/md-knn_a
md-knn_x	$MERLIN_COMPILER_HOME/regression_test/test_case/machsuite_set2/md-knn_x
spmv-crs_a	$MERLIN_COMPILER_HOME/regression_test/test_case/machsuite_set2/spmv-crs_a
sort-merge_a	$MERLIN_COMPILER_HOME/regression_test/test_case/machsuite_set2/sort-merge_a
md-grid_a	$MERLIN_COMPILER_HOME/regression_test/test_case/machsuite_set2/md-grid_a
md-grid_x	$MERLIN_COMPILER_HOME/regression_test/test_case/machsuite_set2/md-grid_x
spmv-crs_x	$MERLIN_COMPILER_HOME/regression_test/test_case/machsuite_set2/spmv-crs_x
sort-merge_x	$MERLIN_COMPILER_HOME/regression_test/test_case/machsuite_set2/sort-merge_x
