knn_a	$MERLIN_COMPILER_HOME/regression_test/test_case/qor_suite/knn_a
pathfinder_a	$MERLIN_COMPILER_HOME/regression_test/test_case/qor_suite/pathfinder_a
kmeans_a	$MERLIN_COMPILER_HOME/regression_test/test_case/qor_suite/kmeans_a
kmp_a	$MERLIN_COMPILER_HOME/regression_test/test_case/qor_suite/kmp_a
stencil-2d_a	$MERLIN_COMPILER_HOME/regression_test/test_case/qor_suite/stencil-2d_a
stencil-3d_a	$MERLIN_COMPILER_HOME/regression_test/test_case/qor_suite/stencil-3d_a
gemm-blocked_a	$MERLIN_COMPILER_HOME/regression_test/test_case/qor_suite/gemm-blocked_a
aes_a	$MERLIN_COMPILER_HOME/regression_test/test_case/qor_suite/aes_a
backprop_a	$MERLIN_COMPILER_HOME/regression_test/test_case/qor_suite/backprop_a
nw_a	$MERLIN_COMPILER_HOME/regression_test/test_case/qor_suite/nw_a
spmv-el_a	$MERLIN_COMPILER_HOME/regression_test/test_case/qor_suite/spmv-el_a
viterbi_a	$MERLIN_COMPILER_HOME/regression_test/test_case/qor_suite/viterbi_a
pathfinder_x	$MERLIN_COMPILER_HOME/regression_test/test_case/qor_suite/pathfinder_x
kmeans_x	$MERLIN_COMPILER_HOME/regression_test/test_case/qor_suite/kmeans_x
backprop_x	$MERLIN_COMPILER_HOME/regression_test/test_case/qor_suite/backprop_x
viterbi_x	$MERLIN_COMPILER_HOME/regression_test/test_case/qor_suite/viterbi_x
stencil-2d_x	$MERLIN_COMPILER_HOME/regression_test/test_case/qor_suite/stencil-2d_x
nw_x	$MERLIN_COMPILER_HOME/regression_test/test_case/qor_suite/nw_x
stencil-3d_x	$MERLIN_COMPILER_HOME/regression_test/test_case/qor_suite/stencil-3d_x
spmv-el_x	$MERLIN_COMPILER_HOME/regression_test/test_case/qor_suite/spmv-el_x
aes_x	$MERLIN_COMPILER_HOME/regression_test/test_case/qor_suite/aes_x
gemm-blocked_x	$MERLIN_COMPILER_HOME/regression_test/test_case/qor_suite/gemm-blocked_x
kmp_x	$MERLIN_COMPILER_HOME/regression_test/test_case/qor_suite/kmp_x
